NO ./textures/north.xpm
SO ./textures/south.xpm
WE ./textures/west.xpm
EA ./textures/east.xpm

F 96,36,27
C 7,153,158

1111
10S0
1111
