NO ./textures/zelda_cavern1.xpm
SO ./textures/zelda_cavern2.xpm
WE ./textures/zelda_red_rock.xpm
EA ./textures/zelda_firetemple_symbol.xpm

F 96,36,27
C 0,0,0

        1111111111111111111111111
        1000000000110000000000001
        1011000001110000000000001
        1001000000000000000000001
111111111011000001110000000000001
100000000011000001110111111111111
11110111111111011100000010001
11110111111111011101010010001
11000000110101011100000010001
10000000000000001100000010001
100000N0000000001101010010001
1100000111010101111101111000111
11110111 1110101 111111010001
11111111 1111111 111111111111
